0000fd10fd37fd13fd15fd17fd19fd10fd10fd380101010101010101010101010101010101010101010101010101010101010101010101010101010101010101010101010101010101010101010101010101010101010101010101010101010100000f0f0f0f0f0f0f0f0f0f0f0f0f0f0f0f0f0f0f0f0f0f0f0f0f0f0f0f0f0f
0000fd20fd47fd23fd25fd27fd29fd20fd20fd480101010101010101010101010101010101010101010101010101010101010101010101010101010101010101010101010101010101010101010101010101010101010101010101010101010100000f0f0f0f0f0f0f0f0f0f0f0f0f0f0f0f0f0f0f0f0f0f0f0f0f0f0f0f0f0f
fd33fd30fd375859b0b0b0b05859fd105a5bfd3901010101010101010101010101010101010101010101010101010101010101010101010101010101010101010101010101010101010101010101010101010101010101010101010101010101fd100f0f0f0f0f0f0f0f0f0f0f0f0f0f0f0f0f0f0f0f0f0f0f0f0f0f0f0f0f0f
fd43fd40fd476869b0b0b0b06869fd206a6bfd4901010101010101010101010101010101010101010101010101010101010101010101010101010101010101010101010101010101010101010101010101010101010101010101010101010101fd200f0f0f0f0f0f0f0f0f0f0f0f0f0f0f0f0f0f0f0f0f0f0f0f0f0f0f0f0f0f
fd10fd10fd37fd34fd35fd36fd10fd10fd1bfd3a01010101010101010101010101010101010101010101010101010101010101010101010101010101010101010101010101010101010101010101010101010101010101010101010101010101fd340f0ffd350f0ffd360f0ffd370f0f0f0f0f0f0f0f0f0f0f0f0f0f0f0f0f0f
fd20fd20fd47fd44fd45fd46fd20fd20fd2bfd4a01010101010101010101010101010101010101010101010101010101010101010101010101010101010101010101010101010101010101010101010101010101010101010101010101010101fd440f0ffd450f0ffd460f0ffd470f0f0f0f0f0f0f0f0f0f0f0f0f0f0f0f0f0f
fd12fd10fd100000fd10fd10fd10fd10fd1cfd3b01010101010101010101010101010101010101010101010101010101010101010101010101010101010101010101010101010101010101010101010101010101010101010101010101010101fd130f0ffd150f0ffd170f0ffd190f0f0f0f0f0f0f0f0f0f0f0f0f0f0f0f0f0f
fd22fd20fd200000fd20fd20fd20fd20fd2cfd4b01010101010101010101010101010101010101010101010101010101010101010101010101010101010101010101010101010101010101010101010101010101010101010101010101010101fd230f0ffd250f0ffd270f0ffd290f0f0f0f0f0f0f0f0f0f0f0f0f0f0f0f0f0f
b0b0b0b0000000000f0ffd10fd10fd50fd3ffd3c01010101010101010101010101010101010101010101010101010101010101010101010101010101010101010101010101010101010101010101010101010101010101010101010101010101fd140f0ffd160f0ffd180f0ffd1a0f0f0f0f0f0f0f0f0f0f0f0f0f0f0f0f0f0f
b0b0b0b0000000000f0ffd20fd20fd60fd4ffd4c01010101010101010101010101010101010101010101010101010101010101010101010101010101010101010101010101010101010101010101010101010101010101010101010101010101fd240f0ffd260f0ffd280f0ffd2a0f0f0f0f0f0f0f0f0f0f0f0f0f0f0f0f0f0f
b0b0b0b000007c7d7c7dfd10fd52c0c0fd3efd3d0101010101010101010101010101010101010101010101010101010101010101010101010101010101010101010101010101010101010101010101010101010101010101010101010101010158590f0f5a5b0f0f5c5d0f0f5e5f0f0f0f0f0f0f0f0f0f0f0f0f0f0f0f0f0f0f
b0b0b0b000008c8d8c8dfd20fd62c0c0fd4efd4d0101010101010101010101010101010101010101010101010101010101010101010101010101010101010101010101010101010101010101010101010101010101010101010101010101010168690f0f6a6b0f0f6c6d0f0f6e6f0f0f0f0f0f0f0f0f0f0f0f0f0f0f0f0f0f0f
7c7db0b0fd1dfd1efd1f0000fd10c0c0c0c05a5b0101010101010101010101010101010101010101010101010101010101010101010101010101010101010101010101010101010101010101010101010101010101010101010101010101010170710f0f72730f0f74750f0f76770f0f0f0f0f0f0f0f0f0f0f0f0f0f0f0f0f0f
8c8db0b0fd2dfd2efd2f0000fd20c0c0c0c06a6b0101010101010101010101010101010101010101010101010101010101010101010101010101010101010101010101010101010101010101010101010101010101010101010101010101010180810f0f82830f0f84850f0f86870f0f0f0f0f0f0f0f0f0f0f0f0f0f0f0f0f0f
7c7d7c7dfd1dfd1efd1f0000fd51c0c0c0c0c0c001010101010101010101010101010101010101010101010101010101010101010101010101010101010101010101010101010101010101010101010101010101010101010101010101010101fd1e0f0ffd1d0f0ffd1f0f0f0f0f0f0f0f0f0f0f0f0f0f0f0f0f0f0f0f0f0f0f
8c8d8c8dfd2dfd2efd2f0000fd61c0c0c0c0c0c001010101010101010101010101010101010101010101010101010101010101010101010101010101010101010101010101010101010101010101010101010101010101010101010101010101fd2e0f0ffd2d0f0ffd2f0f0f0f0f0f0f0f0f0f0f0f0f0f0f0f0f0f0f0f0f0f0f
010101010101010101010101010101010101010101010101010101010101010101010101010101010101010101010101010101010101010101010101010101010101010101010101010101010101010101010101010101010101010101010101fd500f0ffd520f0ffd510f0f0f0f0f0f0f0f0f0f0f0f0f0f0f0f0f0f0f0f0f0f
010101010101010101010101010101010101010101010101010101010101010101010101010101010101010101010101010101010101010101010101010101010101010101010101010101010101010101010101010101010101010101010101fd600f0ffd620f0ffd610f0f0f0f0f0f0f0f0f0f0f0f0f0f0f0f0f0f0f0f0f0f
0101010101010101010101010101010101010101010101010101010101010101010101010101010101010101010101010101010101010101010101010101010101010101010101010101010101010101010101010101010101010101010101017c7d0f0fb0b00f0fc0c00f0f7a7b0f0ffd300f0f0f0f0f0f0f0f0f0f0f0f0f0f
0101010101010101010101010101010101010101010101010101010101010101010101010101010101010101010101010101010101010101010101010101010101010101010101010101010101010101010101010101010101010101010101018c8d0f0fb0b00f0fc0c00f0f8a8b0f0ffd400f0f0f0f0f0f0f0f0f0f0f0f0f0f
01010101010101010101010101010101010101010101010101010101010101010101010101010101010101010101010101010101010101010101010101010101010101010101010101010101010101010101010101010101010101010101010178790f0f0f0f0f0ffd1b0f0ffd1c0f0ffd330f0f0f0f0f0f0f0f0f0f0f0f0f0f
01010101010101010101010101010101010101010101010101010101010101010101010101010101010101010101010101010101010101010101010101010101010101010101010101010101010101010101010101010101010101010101010188890f0f0f0f0f0ffd2b0f0ffd2c0f0ffd430f0f0f0f0f0f0f0f0f0f0f0f0f0f
0101010101010101010101010101010101010101010101010101010101010101010101010101010101010101010101010101010101010101010101010101010101010101010101010101010101010101010101010101010101010101010101010f0f0f0f0f0f0f0f0f0f0f0f0f0f0f0f0f0f0f0f0f0f0f0f0f0f0f0f0f0f0f0f
0101010101010101010101010101010101010101010101010101010101010101010101010101010101010101010101010101010101010101010101010101010101010101010101010101010101010101010101010101010101010101010101010f0f0f0f0f0f0f0f0f0f0f0f0f0f0f0f0f0f0f0f0f0f0f0f0f0f0f0f0f0f0f0f
0101010101010101010101010101010101010101010101010101010101010101010101010101010101010101010101010101010101010101010101010101010101010101010101010101010101010101010101010101010101010101010101010f0f0f0ffd120f0f0f0f0f0f0f0f0f0f0f0f0f0f0f0f0f0f0f0f0f0f0f0f0f0f
0101010101010101010101010101010101010101010101010101010101010101010101010101010101010101010101010101010101010101010101010101010101010101010101010101010101010101010101010101010101010101010101010f0f0f0ffd220f0f0f0f0f0f0f0f0f0f0f0f0f0f0f0f0f0f0f0f0f0f0f0f0f0f
0101010101010101010101010101010101010101010101010101010101010101010101010101010101010101010101010101010101010101010101010101010101010101010101010101010101010101010101010101010101010101010101010f0f0f0f0f0f0f0f0f0f0f0f0f0f0f0f0f0f0f0f0f0f0f0f0f0f0f0f0f0f0f0f
0101010101010101010101010101010101010101010101010101010101010101010101010101010101010101010101010101010101010101010101010101010101010101010101010101010101010101010101010101010101010101010101010f0f0f0f0f0f0f0f0f0f0f0f0f0f0f0f0f0f0f0f0f0f0f0f0f0f0f0f0f0f0f0f
0101010101010101010101010101010101010101010101010101010101010101010101010101010101010101010101010101010101010101010101010101010101010101010101010101010101010101010101010101010101010101010101010f0f0f0f0f0f0f0f0f0f0f0f0f0f0f0f0f0f0f0f0f0f0f0f0f0f0f0f0f0f0f0f
0101010101010101010101010101010101010101010101010101010101010101010101010101010101010101010101010101010101010101010101010101010101010101010101010101010101010101010101010101010101010101010101010f0f0f0f0f0f0f0f0f0f0f0f0f0f0f0f0f0f0f0f0f0f0f0f0f0f0f0f0f0f0f0f
010101010101010101010101010101010101010101010101010101010101010101010101010101010101010101010101010101010101010101010101010101010101010101010101010101010101010101010101010101010101010101010101fd380f0ffd390f0ffd3a0f0ffd3b0f0ffd3c0f0ffd3d0f0ffd3e0f0ffd3f0f0f
010101010101010101010101010101010101010101010101010101010101010101010101010101010101010101010101010101010101010101010101010101010101010101010101010101010101010101010101010101010101010101010101fd480f0ffd490f0ffd4a0f0ffd4b0f0ffd4c0f0ffd4d0f0ffd4e0f0ffd4f0f0f
