0000fd10fd37fd13fd15fd17fd19fd10fd10fd3801010101010101010101010101010101010101010101010101010101010101010101010101010101010101010101010101010101010101010101010101010101010101010101010101010101000000090600030103030f0f0f0f0f0f0f0f0f0f0f0f0f0f0f0f0f0f0f0f0f0f
0000fd20fd47fd23fd25fd27fd29fd20fd20fd480101010101010101010101010101010101010101010101010101010101010101010101010101010101010101010101010101010101010101010101010101010101010101010101010101010100000c08060d000900000f0f0f0f0f0f0f0f0f0f0f0f0f0f0f0f0f0f0f0f0f0f
fd33fd30fd375859b0b0b0b05859fd105a5bfd3901010101010101010101010101010101010101010101010101010101010101010101010101010101010101010101010101010101010101010101010101010101010101010101010101010101fd10020303030709070b0f0f0f0f0f0f0f0f0f0f0f0f0f0f0f0f0f0f0f0f0f0f
fd43fd40fd476869b0b0b0b06869fd206a6bfd4901010101010101010101010101010101010101010101010101010101010101010101010101010101010101010101010101010101010101010101010101010101010101010101010101010101fd20040c0e0d000900000f0f0f0f0f0f0f0f0f0f0f0f0f0f0f0f0f0f0f0f0f0f
fd10fd10fd37fd34fd35fd36fd10fd10fd1bfd3a01010101010101010101010101010101010101010101010101010101010101010101010101010101010101010101010101010101010101010101010101010101010101010101010101010101fd34060bfd350009fd360f0ffd370f0f0f0f0f0f0f0f0f0f0f0f0f0f0f0f0f0f
fd20fd20fd47fd44fd45fd46fd20fd20fd2bfd4a01010101010101010101010101010101010101010101010101010101010101010101010101010101010101010101010101010101010101010101010101010101010101010101010101010101fd44040cfd450009fd460f0ffd470f0f0f0f0f0f0f0f0f0f0f0f0f0f0f0f0f0f
fd12fd10fd100000fd10fd10fd10fd10fd1cfd3b01010101010101010101010101010101010101010101010101010101010101010101010101010101010101010101010101010101010101010101010101010101010101010101010101010101fd130600fd150303fd170f0ffd190f0f0f0f0f0f0f0f0f0f0f0f0f0f0f0f0f0f
fd22fd20fd200000fd20fd20fd20fd20fd2cfd4b01010101010101010101010101010101010101010101010101010101010101010101010101010101010101010101010101010101010101010101010101010101010101010101010101010101fd23040cfd25000dfd270f0ffd290f0f0f0f0f0f0f0f0f0f0f0f0f0f0f0f0f0f
b0b0b0b0000000000303fd10fd10fd50fd3ffd3c01010101010101010101010101010101010101010101010101010101010101010101010101010101010101010101010101010101010101010101010101010101010101010101010101010101fd140303fd16070bfd180f0ffd1a0f0f0f0f0f0f0f0f0f0f0f0f0f0f0f0f0f0f
b0b0b0b0000000000e0dfd20fd20fd60fd4ffd4c01010101010101010101010101010101010101010101010101010101010101010101010101010101010101010101010101010101010101010101010101010101010101010101010101010101fd240c0cfd26000dfd280f0ffd2a0f0f0f0f0f0f0f0f0f0f0f0f0f0f0f0f0f0f
b0b0b0b000007c7d7c7dfd10fd52c0c0fd3efd3d010101010101010101010101010101010101010101010101010101010101010101010101010101010101010101010101010101010101010101010101010101010101010101010101010101015859070b5a5b000b5c5d0f0f5e5f0f0f0f0f0f0f0f0f0f0f0f0f0f0f0f0f0f0f
b0b0b0b000008c8d8c8dfd20fd62c0c0fd4efd4d0101010101010101010101010101010101010101010101010101010101010101010101010101010101010101010101010101010101010101010101010101010101010101010101010101010168690c0c6a6b000d6c6d0f0f6e6f0f0f0f0f0f0f0f0f0f0f0f0f0f0f0f0f0f0f
7c7db0b0fd1dfd1efd1f0000fd10c0c0c0c05a5b010101010101010101010101010101010101010101010101010101010101010101010101010101010101010101010101010101010101010101010101010101010101010101010101010101017071000b7273070074750f0f76770f0f0f0f0f0f0f0f0f0f0f0f0f0f0f0f0f0f
8c8db0b0fd2dfd2efd2f0000fd20c0c0c0c06a6b0101010101010101010101010101010101010101010101010101010101010101010101010101010101010101010101010101010101010101010101010101010101010101010101010101010180810c0c8283000d84850f0f86870f0f0f0f0f0f0f0f0f0f0f0f0f0f0f0f0f0f
7c7d7c7dfd1dfd1efd1f0000fd51c0c0c0c0c0c001010101010101010101010101010101010101010101010101010101010101010101010101010101010101010101010101010101010101010101010101010101010101010101010101010101fd1e0700fd1d0000fd1f0f0f0f0f0f0f0f0f0f0f0f0f0f0f0f0f0f0f0f0f0f0f
8c8d8c8dfd2dfd2efd2f0000fd61c0c0c0c0c0c001010101010101010101010101010101010101010101010101010101010101010101010101010101010101010101010101010101010101010101010101010101010101010101010101010101fd2e0c0cfd2d000dfd2f0f0f0f0f0f0f0f0f0f0f0f0f0f0f0f0f0f0f0f0f0f0f
010101010101010101010101010101010101010101010101010101010101010101010101010101010101010101010101010101010101010101010101010101010101010101010101010101010101010101010101010101010101010101010101fd500000fd520203fd510f0f0f0f0f0f0f0f0f0f0f0f0f0f0f0f0f0f0f0f0f0f
010101010101010101010101010101010101010101010101010101010101010101010101010101010101010101010101010101010101010101010101010101010101010101010101010101010101010101010101010101010101010101010101fd600c0cfd620600fd610f0f0f0f0f0f0f0f0f0f0f0f0f0f0f0f0f0f0f0f0f0f
0101010101010101010101010101010101010101010101010101010101010101010101010101010101010101010101010101010101010101010101010101010101010101010101010101010101010101010101010101010101010101010101017c7d0201b0b0060bc0c00f0f7a7b0f0ffd300f0f0f0f0f0f0f0f0f0f0f0f0f0f
0101010101010101010101010101010101010101010101010101010101010101010101010101010101010101010101010101010101010101010101010101010101010101010101010101010101010101010101010101010101010101010101018c8d0609b0b00600c0c00f0f8a8b0f0ffd400f0f0f0f0f0f0f0f0f0f0f0f0f0f
01010101010101010101010101010101010101010101010101010101010101010101010101010101010101010101010101010101010101010101010101010101010101010101010101010101010101010101010101010101010101010101010178790609070b0600fd1b0f0ffd1c0f0ffd330f0f0f0f0f0f0f0f0f0f0f0f0f0f
010101010101010101010101010101010101010101010101010101010101010101010101010101010101010101010101010101010101010101010101010101010101010101010101010101010101010101010101010101010101010101010101888906090e0d0600fd2b0f0ffd2c0f0ffd430f0f0f0f0f0f0f0f0f0f0f0f0f0f
01010101010101010101010101010101010101010101010101010101010101010101010101010101010101010101010101010101010101010101010101010101010101010101010101010101010101010101010101010101010101010101010102010301000b0303000b0f0f0f0f0f0f0f0f0f0f0f0f0f0f0f0f0f0f0f0f0f0f
01010101010101010101010101010101010101010101010101010101010101010101010101010101010101010101010101010101010101010101010101010101010101010101010101010101010101010101010101010101010101010101010104080e090e0d0e0000000f0f0f0f0f0f0f0f0f0f0f0f0f0f0f0f0f0f0f0f0f0f
01010101010101010101010101010101010101010101010101010101010101010101010101010101010101010101010101010101010101010101010101010101010101010101010101010101010101010101010101010101010101010101010106090709fd12070b07000f0f0f0f0f0f0f0f0f0f0f0f0f0f0f0f0f0f0f0f0f0f
01010101010101010101010101010101010101010101010101010101010101010101010101010101010101010101010101010101010101010101010101010101010101010101010101010101010101010101010101010101010101010101010104080e09fd220e0000000f0f0f0f0f0f0f0f0f0f0f0f0f0f0f0f0f0f0f0f0f0f
010101010101010101010101010101010101010101010101010101010101010101010101010101010101010101010101010101010101010101010101010101010101010101010101010101010101010101010101010101010101010101010101030100090700000b00000f0f0f0f0f0f0f0f0f0f0f0f0f0f0f0f0f0f0f0f0f0f
0101010101010101010101010101010101010101010101010101010101010101010101010101010101010101010101010101010101010101010101010101010101010101010101010101010101010101010101010101010101010101010101010c080e090e0d0e0000000f0f0f0f0f0f0f0f0f0f0f0f0f0f0f0f0f0f0f0f0f0f
01010101010101010101010101010101010101010101010101010101010101010101010101010101010101010101010101010101010101010101010101010101010101010101010101010101010101010101010101010101010101010101010107090203000007000f0f0f0f0f0f0f0f0f0f0f0f0f0f0f0f0f0f0f0f0f0f0f0f
0101010101010101010101010101010101010101010101010101010101010101010101010101010101010101010101010101010101010101010101010101010101010101010101010101010101010101010101010101010101010101010101010c08060d0e0d0e000f0f0f0f0f0f0f0f0f0f0f0f0f0f0f0f0f0f0f0f0f0f0f0f
010101010101010101010101010101010101010101010101010101010101010101010101010101010101010101010101010101010101010101010101010101010101010101010101010101010101010101010101010101010101010101010101fd38060bfd390000fd3a0f0ffd3b0f0ffd3c0f0ffd3d0f0ffd3e0f0ffd3f0f0f
010101010101010101010101010101010101010101010101010101010101010101010101010101010101010101010101010101010101010101010101010101010101010101010101010101010101010101010101010101010101010101010101fd48060dfd490e00fd4a0f0ffd4b0f0ffd4c0f0ffd4d0f0ffd4e0f0ffd4f0f0f
